######
# #..#
# #$$#
#  @ #
# #  #
######
