######
#*#  #
#  * #
# #@ #
# #  #
######
