######
#*#  #
#  . #
# #$ #
# # @#
######
