######
# #*.#
# # $#
#   @#
# #  #
######
