######
# #**#
# # @#
#    #
# #  #
######
