######
#.   #
# ##.#
#$# $#
#B A #
######
