######
#A $.#
#    #
##$###
# .B #
######
