######
#B . #
# #  #
#.$$##
# # A#
######
