######
#  * #
# #@ #
#.$ ##
# #  #
######
