######
#  . #
# #  #
#.$$##
# # @#
######
