######
#.   #
# $# #
##@  #
#  #*#
######
