######
#.$ @#
#  # #
##   #
#  #*#
######
