######
#.$  #
#  # #
## @ #
#  #*#
######
