######
#*@  #
#  # #
##   #
#  #*#
######
