######
#  * #
# #  #
#*@ ##
# #  #
######
