######
# ## #
# ## #
#A##B#
#*  *#
######
