######
#*   #
#@##*#
# #  #
#    #
######
