######
#.   #
# ##*#
#$#  #
#@   #
######
