######
#.   #
# ##.#
#$# $#
#  @ #
######
