######
#.   #
# ##*#
#$#  #
#   @#
######
