######
#   B#
# $. #
### ##
#.$ A#
######
