######
#A##B#
#$##$#
# ## #
#.  .#
######
