######
#   .#
#$ #B#
# $# #
#. A #
######
