######
# #.B#
# #$$#
#  A #
# #  #
######
