######
#    #
#@$. #
### ##
#*   #
######
