######
#    #
# @* #
### ##
#*   #
######
