######
#  @ #
# $. #
### ##
#*   #
######
