######
#    #
# $. #
### ##
#* @ #
######
