######
#    #
# $. #
### ##
#.$ @#
######
