######
#  @*#
#  # #
#  # #
#*   #
######
