######
#  @.#
#$$# #
#  # #
#.   #
######
