######
#   .#
#$$# #
#  # #
#.@  #
######
