######
#   .#
#$$# #
#  #@#
#.   #
######
