######
# $ .#
# @# #
#  # #
#*   #
######
