######
#   .#
#$ # #
# $# #
#. @ #
######
