######
# @$.#
#  # #
#  # #
#*   #
######
