######
#   .#
#@$# #
#$ # #
#.   #
######
