######
#@ $.#
#    #
##$###
# .  #
######
