######
#   *#
#    #
##@###
# *  #
######
