######
#   *#
#  @ #
##$###
# .  #
######
